0#########> 0###2
| ..........|...|
|.<##>.<##2.v.^.|
|.........|...|.|
6#>.^.<#>.6#>.|.|
 ...|........O|.| 
^.0#8.^x<#>.^.v.| 
|.|..O|...y.|...|
|.|.^.|.*.^.|.^.|
|.v.|.v.*.|.v.|.|
|...|.y...|...|.|
|.^.v.<#>xv.0#8.v
|.|.........|... 
|.|.<#2.<#>.v.<#2
|.|...|........O|
|.v.^.6#>.<###>.|
|O..|...........|
6###8 <#########8